10 10 10 10 10 10 10 10 10 10 10 10 10 10 10 10 10 10 10 10 10 10 10 10 10 10 10 10 10 10 10 10 10 10 10 10 10 10 10 10 10 10 10 10 10 10 10 10 10 10 10 10 10 10 10 10 10 10 10 10 10 10 10 10 10 10 10 10 10 10 10 10 10 10 10 10 10 10 10 10 10 10 10 10 10 10 10 10 10 10 10 10 10 10 10 10 10 10 10 10 10 10 10 10 10 10 10 10 10 10 10 10 10 10 10 10 10 10 10 10 10 10 10 10 10 10 10 10 10 10 10 10 10 10 10 10 10 10 10 10 10 10 10 10 10 10 10 26 10 10 10
10 10 10 15 15 10 10 10 10 10 10 10 10 10 10 10 10 10 10 10 10 10 10 10 10 10 10 10 10 10 10 10 10 10 10 10 10 10 10 10 10 10 15 10 10 10 10 10 10 10 10 10 10 10 10 10 10 10 10 10 10 10 10 10 10 10 10 10 10 10 10 10 10 10 10 10 10 10 10 10 10 10 10 10 10 10 10 10 10 10 10 10 10 10 10 10 10 23 10 10 10 10 10 10 10 15 15 10 10 10 10 10 10 10 10 10 10 10 10 10 10 10 10 10 10 10 10 10 10 10 10 10 10 10 10 10 10 10 10 10 10 10 10 10 15 10 10 26 10 10 10
10 10 10 11 11 15 10 10 15 15 10 10 10 10 10 10 10 10 10 10 10 10 10 10 10 10 10 10 10 10 10 10 10 10 10 10 10 10 10 10 11 11 11 11 10 10 10 10 10 10 10 10 10 10 10 10 10 10 10 10 10 10 10 10 10 10 10 10 10 10 10 10 10 10 10 15 10 10 10 10 10 10 10 10 10 10 10 10 10 10 10 10 24 10 10 10 11 11 11 10 10 10 10 10 10 15 15 10 10 10 15 15 10 10 10 10 10 10 10 10 10 10 10 10 10 10 10 10 10 10 10 10 10 10 10 10 10 10 10 10 10 15 10 10 19 10 10 26 10 10 10
10 10 10 10 12 11 15 15 19 19 15 15 10 10 10 10 10 10 10 10 10 10 10 10 10 10 10 10 10 10 10 10 10 10 10 10 10 15 10 10 10 15 15 15 10 10 10 10 10 10 10 10 10 10 10 10 10 10 10 10 10 10 10 10 10 10 10 10 10 10 10 15 10 10 10 23 10 10 10 10 10 10 10 15 10 10 10 10 22 10 10 10 11 11 10 10 19 15 15 10 10 10 10 10 10 19 19 10 10 10 15 15 10 10 10 10 10 10 10 10 10 10 10 10 10 10 10 10 10 15 10 10 10 10 10 10 10 10 10 10 10 19 10 10 10 10 10 26 10 10 26
10 10 10 10 10 12 11 11 11 11 11 11 15 15 10 10 10 10 10 10 10 10 10 10 10 10 10 10 10 10 10 10 10 10 10 10 11 11 11 10 10 19 19 19 10 10 10 10 10 10 10 10 10 10 10 10 10 10 10 10 10 10 10 10 10 10 10 15 10 10 10 23 10 10 10 11 10 10 10 15 10 10 10 23 10 10 10 11 11 10 10 10 10 10 10 10 19 19 19 10 10 10 10 10 11 11 11 11 10 10 10 10 10 10 15 10 10 10 15 10 10 10 10 15 15 10 10 10 15 10 10 10 10 15 15 10 10 10 10 10 10 10 10 10 10 10 10 26 10 10 26
10 10 10 10 10 10 12 12 12 10 10 10 11 11 10 10 10 10 10 10 10 10 10 10 10 10 10 10 10 10 10 10 15 10 10 10 10 10 10 10 10 10 10 10 10 10 10 10 10 15 10 10 10 10 10 10 10 10 10 10 10 10 10 10 10 10 10 23 10 10 10 11 10 10 10 12 10 10 10 23 10 10 10 11 10 10 10 10 10 10 10 10 10 10 10 10 10 10 10 10 10 10 10 10 10 12 12 10 10 10 19 19 10 10 10 10 10 10 10 10 10 10 10 10 10 10 10 10 10 19 10 10 10 10 10 10 10 10 10 10 10 10 15 15 10 10 10 10 10 99 10
10 10 10 10 10 10 12 12 10 10 10 10 10 10 10 10 10 10 10 10 10 10 10 10 10 10 10 10 10 10 10 11 11 11 10 10 10 10 10 10 10 10 10 10 10 10 10 10 11 11 11 10 10 10 10 10 15 15 10 10 10 15 15 10 10 10 10 11 10 10 10 12 10 10 10 12 10 10 10 11 10 10 10 12 24 10 10 10 10 10 10 10 10 10 10 10 10 10 10 10 10 10 10 10 10 12 12 10 10 10 10 10 10 10 19 10 15 10 19 10 15 10 15 19 19 15 15 15 19 15 15 15 15 19 19 10 10 10 10 10 15 15 21 19 10 10 10 10 10 10 26 
10 10 10 10 10 10 12 12 10 10 10 10 10 24 22 10 10 10 15 15 10 10 15 15 10 10 10 23 10 10 10 10 10 10 10 10 10 10 10 10 10 10 10 10 10 10 10 10 12 12 12 10 10 10 10 10 15 15 10 10 10 15 15 10 10 10 11 12 13 13 13 12 13 13 13 12 13 13 13 12 13 13 13 12 11 11 10 10 10 10 10 10 10 10 10 10 10 10 10 10 10 10 10 10 10 12 12 10 10 10 10 10 10 10 10 10 15 15 10 10 15 10 15 10 15 10 10 10 10 15 10 10 10 10 10 10 10 10 10 10 19 21 10 10 10 10 10 11 11 11 11
10 10 10 10 10 10 10 10 10 10 20 11 11 11 11 11 10 10 19 19 10 10 21 19 10 10 11 11 11 11 10 10 24 10 20 22 10 10 10 20 10 10 10 10 10 10 10 10 12 12 12 10 10 10 20 22 10 10 10 20 22 10 10 10 20 11 12 12 14 14 14 12 14 14 14 12 14 14 14 12 14 14 14 12 12 12 22 10 10 10 10 10 10 10 10 10 10 10 10 10 10 10 10 10 10 12 12 10 10 10 10 10 10 10 10 10 15 10 15 10 15 10 15 10 15 10 10 10 10 15 15 15 15 10 10 10 10 11 11 10 10 10 10 10 10 10 10 12 12 12 12
22 24 20 10 10 10 12 12 12 12 12 12 12 12 12 12 13 13 13 13 13 13 13 13 13 13 12 12 12 12 11 11 11 11 11 11 11 11 11 11 13 13 13 13 13 13 13 13 12 12 12 11 11 11 11 11 11 11 11 11 11 11 11 11 11 12 12 12 14 14 14 12 14 14 14 12 14 14 14 12 14 14 14 12 12 12 11 11 10 10 10 10 10 10 10 10 10 10 10 10 10 10 10 10 10 12 12 10 10 10 10 10 10 10 10 10 15 10 10 15 15 10 15 10 15 10 10 10 10 15 10 10 10 10 10 11 11 12 12 13 13 13 13 13 13 13 13 12 12 12 12
11 11 11 11 11 11 12 12 12 12 12 12 12 12 12 12 14 14 14 14 14 14 14 14 14 14 12 12 12 12 12 12 12 12 12 12 12 12 12 12 14 14 14 14 14 14 14 14 12 12 12 12 12 12 12 12 12 12 12 12 12 12 12 12 12 12 12 12 14 14 14 12 14 14 14 12 14 14 14 12 14 14 14 12 12 12 12 12 10 10 10 20 10 10 10 10 10 20 10 10 10 10 10 20 10 18 18 10 10 20 10 10 10 10 10 20 15 10 10 10 15 20 15 10 10 15 15 15 20 15 15 15 15 10 10 12 12 12 12 14 14 14 14 14 14 14 14 12 12 12 12
12 12 12 12 12 12 12 12 12 12 12 12 12 12 12 12 12 12 12 12 12 12 12 12 12 12 12 12 12 12 12 12 12 12 12 12 12 12 12 12 12 12 12 12 12 12 12 12 12 12 12 12 12 12 12 12 12 12 12 12 12 12 12 12 12 12 12 12 12 12 12 12 12 12 12 12 12 12 12 12 12 12 12 12 12 12 12 12 12 12 12 12 25 25 25 25 25 12 25 25 25 25 25 12 12 12 12 12 12 12 25 25 25 25 25 12 25 25 25 25 25 12 25 25 25 25 25 12 25 25 25 25 25 12 12 12 12 12 12 12 12 12 12 12 12 12 12 12 12 12 12
12 12 12 12 12 12 12 12 12 12 12 12 12 12 12 12 12 12 12 12 12 12 12 12 12 12 12 12 12 12 12 12 12 12 12 12 12 12 12 12 12 12 12 12 12 12 12 12 12 12 12 12 12 12 12 12 12 12 12 12 12 12 12 12 12 12 12 12 12 12 12 12 12 12 12 12 12 12 12 12 12 12 12 12 12 12 12 12 12 12 12 12 12 12 12 12 12 12 12 12 12 12 12 12 12 12 12 12 12 12 12 12 12 12 12 12 12 12 12 12 12 12 12 12 12 12 12 12 12 12 12 12 12 12 12 12 12 12 12 12 12 12 12 12 12 12 12 12 12 12 12